11111111111111111111111111111111111111111111
10000000000000000000C00000000000000000000001
1000000C000000000C00000000000000000C00000001
11111110000000000000000000000C00000000000001
100000C00000000E00000000000000000000P0000011
1000000000C000000111111111111111111111111111
1000000000000001111110000000C000000000000001
11111111C00000000000000000000000C00000000111
11111111111111111111111111111111111111111111