11111111111111111111111111111
10000000000000000000000000001
1000000000E000000C00111000101
100000000100000000001P1000001
11111111111111111111111111111
