11111111111111111111111111111
1000000N0011100000000000P0001
10000000001C10000000000C00001
10000000E01110000000000000001
11111111111111111111111111111