11111111111111111111111111111
10000000000000000000000000001
1000000000P000000C00111000101
100000000100000000001E1000001
11111111111111111111111111111
