11111111111111111111111111111
12000000000000N00000000000001
10000N00000C00000000000000C01
10000000E00000000000000000001
11111111111111111111111111111