11111111111111111111111111111
100000000000000000000000P0001
10000000000C00000000000000C01
10000000C00000000000000000001
11111111111111111111111111111