11111111111111111111111111111
100000000000000000000000P0001
1000N000000000000000000000E01
10000000N00000000000000000001
11111111111111111111111111111
