11111111111111111111111111111111111111111111
100000000000N0000000C00000000000000000000001
1000000C000000000C00000000N00000000C00000001
11111110000000000000000000000C00000000000001
100000C00000000E00000000000000000000P0000011
10000N0000C000000111111111111111111111111111
1000000000000001111110000000C000000000N00001
11111111C0000N000000000000000000C00000000111
11111111111111111111111111111111111111111111