11111111111111111111111111111111111111111111
111110000000N0000000C00000110000000000000011
1000000C000000000C00000000N00000000C00000001
11111110000000000000000000000C00000000000001
100000C00000000E00000111000000000000P0000011
1111000000000000000000000N000000000011111111
10000N0000C00000N111111111111111111111111111
1111000011111100000000000C000000000000001111
10000000000000111111000000NC000000000N000011
11111111C0000N000000000000000000C00001111111
11111111111111111111111111111111111111111111