11111111111111111111111111111111111111111111
100000000000N0000000C00000000000000000000001
1000000C000000000C00000000N00000000C00000001
11111110000000000000N00000000C00000000000001
100000C00000000E00000000000000000000P0000011
1111000000000000000000000N000000000011111111
10000N0000C00000N111111111111111111111111111
10N0000011111100000000000C000000000000001111
10000000000000111111000000NC000000000N000011
11111111C0000N000000000000000000C00000000111
1111111111000C000000000C000N1111111111111111
1111111111111111000C000000000C00011111111111
11111000C000000000C000N111111111111111111111
11111111111111111111111111111111111111111111